############
#..+..$.+..#
##.$#+##.$##
#.+.###.+..#
#.##+.#..#.#
#.+.$.#$..$#
#.#$#.#.#..x
#.$+#.+.$..#
############
