############
#..+.$.+..##
########.&.#
#.+.$##.+..#
#.#+$.#..#.#
#......#....
x.#$#..#$.##
#.$+#.+.$#.#
############
