############
#&.+..$.+..#
##.$#+##.$##
#.+.###.+..#
#.##+.#..#.#
#.+...#$..$#
#.#$#.#.#..x
#.$+#.+.$..#
############
